12 12
############
#*........*#
##..########
#*..#..#####
##...O.##*##
##OO...O...#
#*.O.OO.O..#
#####..#..##
#*.@#..#..*#
#......#####
#.........*#
############