10 10
##########
#*..##..*#
##......##
#*..#O#..#
##..#...##
##..###..#
#*.OO..O.#
##..OO#.##
#*.@....*#
##########